########
#PO    #
#  II  #
#   @$!#
#   ####
#O  BGR#
########

########
#PO    #
#      #
#   @$!#
#   ####
#O  BGR#
########

#####
#PO##
#####
#G O#
#####